NO textures/dark_theme/north.xpm
SO textures/dark_theme/south.xpm
WE textures/dark_theme/west.xpm   
EA textures/dark_theme/east.xpm

F 25,0,51
C 51,0,102

1111111111
1101100001
11N1000011
1100011001
1001110011
1100000001
1111111111
