NO textures/minecraft_theme/bookshelf.xpm
SO textures/minecraft_theme/bricks.xpm
WE textures/minecraft_theme/Sand.xpm   
EA textures/minecraft_theme/stone.xpm

F 0,102,61
C 210,248,255

            11
        1111S01111
    111110000000111111
11111000000000000000011111
10000000000000000000000001
11111000000000000000011111
10001DDD10000000011DDD0001
10000000111100111100000001
1000000000001D000000000001
10000000000000000000000001
10000000000000000000000001
10000000000000000000000001
11111000000000000000011111
    111110000000011111
        1111001111
            11
