NO textures/dark_theme/north.xpm
SO textures/dark_theme/south.xpm
WE textures/dark_theme/west.xpm   
EA textures/dark_theme/east.xpm

F 25,0,51
C 51,0,102

      111
    11101
    100S01
    111011      11
      1D1      11011
1111111011   1110001111111
1000100001  10010000D000001
10000000111110100011110001
 10001100D000010000000001
100111000110000000011111
1100D000010000000001
11011111110000110001
 111  1100001111101
       11001   10001
        1001    111
        1001
        1111

