NO textures/dark_theme/north.xpm
SO textures/dark_theme/south.xpm
WE textures/dark_theme/west.xpm   
EA textures/dark_theme/east.xpm

F 25,0,51
C 51,0,102


1111
1001
1S01
101
101
101
101
101
101
101
101
101
101
101
101
101
101
101
101
101
101
101
101
101
101
101
101
101
101
101
101
101
101
111

