NO textures/64x/bookshelf.png
SO textures/64x/WaterF1.xpm
WE textures/purple_stone.xpm   
EA textures/64x/Planks.xpm

F 250,0,0
C 251,241,15

1111111111
1000100001
10N0000011
1100011001
1001110011
1100000001
1101111111

