

NO   textures/dark_theme/north.xpm



       	SO 		   textures/dark_theme/south.xpm            
   WE     textures/dark_theme/west.xpm     
  EA     	textures/dark_theme/east.xpm

F 			0,0,33
  C 		51,0,102
1111111111
1000100001
10S0000011
1100011001
1001110011
1100000001
1111111111










