NO inc_bonus/wall/north.xpm
W inc_bonus/wall/west.xpm   
SO inc_bonus/wall/south.xpm
EA inc_bonus/wall/east.xpm
F 250,0,0

F 250,0,0
C 251,241,15

      111
    11101
    100S01
    111011      11
      101      11011
1111111011   1110001111111
1000100001  100100000000001
10000000111110100011110001
 100011000000010000000001
100111001100000000011111
11000000010000000001
11011111110000110001
 111  1100001111101
       11001   10001
        1001    111
        1001
        1111

