NO      inc/purple_stone.xpm
SO   inc/round_stone.xpm
WE        inc/rustic_stone.xpm
EA inc/small_stone.xpm

F     220,100,0
 
C 225,30,0    


        11111111111111111111111111
        100000000011000000000000001
        101100000111000000000000001
        100100000000000000000000001
11111111101100000111000000000000001
10000000001100000111011111111111011
11110111111111011100000010001  101
11110111111111011101010010001  111
11011100110101011100000010001
1001 100000000001100000010001
10011100000000001101010010001
11000001110101011111011110N01
11110111 1110101 101111010001
1 1 1111 1111111 111111111111
