NO textures/64x/bookshelf.png
SO textures/dark_theme/south.xpm
WE textures/dark_theme/west.xpm   
EA textures/dark_theme/east.xpm

F 25,0,51
C 51,0,102

1111110111
1000100001
10N0000011
1100011001
1001110011
1100000001
1111111111

