NO      textures/64x/bookshelf.xpm
                    SO                  textures/64x/WaterF1.xpm
           W                   textures/purple_stone.xpm   
EA textures/64x/Planks.xpm

F     0,0,33
                 

C  251,241,15

1        1111111111111111111111111111111111111111111111111111
        100000000011000000000000001   
        101100000111000000000000001  
        100100000000000000000000001   
11111111101100000111000000000000001
10000000001100000111011001111111011
11110111111111011100000010001  101
1111011111 111011101010010001  111
11011100111101011100000000001
1001 100000000000D00000000001
10011100000000001101010010001
11000001110101011111011110W011111111111111111111111111111
11110111 1110101 101111010001
1 1 1111 1111111 111111111111

